###################
#@   #      #     #
#    #      #  &  #
#    #      #     #
#    ### #     ####
#        #        #
#    #   #####    #
######   #        #
#        #        #
#   ######        #
#      #    #### ##
#   &  #          #
#    ###   ###    #
#     #      #    #
#    ##   #  #    #
#         #  #    #
#         #  #    #
#         #       #
#         #     & #
###################
