###################
#@   #      #     #
#    #      #  &  #
#    #      #     #
#    #####     ####
#        #        #
#    #   #####    #
######   #        #
#        #        #
#   ######        #
#     ##    ##### #
#   & ##          #
#   #### #####    #
#     #      #    #
#    ##   #  #    #
#         #  #    #
#         #  #    #
#         #       #
#         #      &#
###################
