###################
#@   #      #  i  #
#    #  &   #     #
#    #      # &   #
#    ### #     ####
#   &    #        #
#    #   #####    #
######   #     i  #
#        #   &    #
#   ######        #
#      #    #### ##
#   &  #  &       #
#    ###   ###    #
#     #      #    #
#    ##   #  #    #
#         #  #    #
#     &   #  #    #
#         #       #
# &   i   #     & #
###################
